apache_conf|htaccess|htgroups|htpasswd|htaccess|htgroups|htpasswd => ApacheConf
AppleScript => AppleScript
c_cpp|cpp|c|cc|cxx|h|hh|hpp => C/C++
css => CSS
csharp|cs => C#
clojure|clj|cljs => Clojure
coffee|coffeescript|cf|cson|Cakefile => CoffeeScript
common_lisp|commonlisp|lisp => Common Lisp
Conf => Conf
Dart => Dart
diff|patch => Diff
erb|html_ruby|rhtml|html.erb => RubyHtml (Erb)
Elixir => Elixir
erlang|erl|hrl => Erlang
Factor => Factor
gherkin|feature => Gherkin
go|golang => Go
Groovy => Groovy
Haml => Haml
handlebars|hbs|tpl|mustache => Handlebars
haskell|hs => Haskell
html|htm|xhtml => Html
HTTP => Http
ini|cfg|prefs => IniConf
IO => IO
JSON => JSON
Java => Java
Javascript => JavaScript
LLVM => LLVM
Liquid => Liquid
LiterateCoffeescript => LiterateCoffeeScript
LiterateHaskell => LiterateHaskell
Lua => Lua
Makefile|GNUmakefile|makefile|OCamlMakefile|make|MAKEFILE => MakeFile
markdown|md => MarkDown
Matlab => Matlab
Moonscript => MoonScript
Nginx => NginxConf
Nim => Nim
ocaml|ml|mli => Ocaml
objective_c|objectivec|m|mm => Objective-C
pascal => Pascal
php|phtml => PHP
perl|pl|pm => Perl
prolog|plg => Prolog
Properties => Properties
Puppet => Puppet
python|py => Python
Qml => Qml
R => R
Racket|rkt => Racket
ruby|rb|gemspec|rake|Guardfile|Rakefile|Gemfile => Ruby
rust|rs => Rust
SML => SML
sql|mysql => SQL
sass => SASS
SassCommon => SassCommon
Scala => Scala
scheme|scm => Scheme
Scss => SCSS
Sed => Sed
Shell => Bash/Shell
Slim => Slim
Smalltalk => Smalltalk
Swift => Swift
TCL => TCL
TOML => TOML
TeX => TeX
VimL => VimL
visualbasic|vbs|vbscript|vb|vb.net|vba|vbnet => Visual Basic
xml|rdf|rss|wsdl|xslt|atom|mathml|mml|xul|xbl => XML
yaml|yml => YAML